# Mappa generata con difficolta: 2
# Terreni: M=Muro, G=Ghiaccio, T=Terreno normale, I=Ingresso, E=Uscita, D=Ghiaccio fragile (si rompe dopo 1 passaggio)
# Mosse minime richieste (cambi direzione): 18
# Mosse totali nella sequenza: 19
# Sequenza completa: SINISTRA -> SU -> DESTRA -> SU -> SINISTRA -> SU -> SINISTRA -> SU -> DESTRA -> GIU -> DESTRA -> SU -> DESTRA -> SU -> DESTRA -> DESTRA -> GIU -> SINISTRA -> GIU
width=31
height=27
difficulty=2
min_moves=18
total_moves=19

MMMMMMMMMMMMMMMMMMMMMMMMMMMMMMM
MMGGGMMGGGTGGGGMGGGGGTGGGMGGGGM
MGGGGMMGGMGGGGGGTGGGMMMMGMMGGGM
MGGGGGGTGGGMGMGMMMGGMMMTGMMGGMM
MGGGGMGGGGGDGGMGGGGGMTMEMMGGMGM
MGGMGGGGGGGGGGGGMGGGGGGGGGGGGGM
MMMGGGGGGGMGGGMGGGGGGGTGGGGGGGM
MMMMMMMGGGMGMMMGTGGMGGMGGGMMMMM
MGGMMMMGGGGGMTTGMMMMGMMGGGGGMMM
MGGMMMGDMGGGTMMGMMMDGGGGGDGGGGM
MMGMMMTMMMGGGMGDMMMMMMMGGGGGGGM
MMMMMMMMMMGGGGGMMGTMMMGMGGGGTGM
MMMMMMGMMMGGGGMMMGGMMMGGGGGMGGM
MMMMGGTMGGGGGGMMGGGGGGGGGGGTGGM
MMGGGGMMGGGMGMMMGDMMGGGGGGGGGGM
MGMGGGMMGMMGGGTMGGMMGGGGGMMGGGM
MGGGGMGGGMGGMGGMGGGGMMMGMTMGMGM
MMTGGGGGGMMMGGMGMMGGGMMMDMMMMMM
MMGGTGGGGMMMGGGGMMMMTGGMMMMMMMM
MGMGGGGGGMMMMMGGGMTMMDGMMMGTMMM
MGGTGGGGGGGGGGGGGGTMMGGMMMTGGGM
MGMGGMGGGTGGGGDGGMGGMMGGGDGGGGM
MGGGMMMMGGGDDGMGMGMGMTMGGGGGMGM
MMGGGMMMGGGGGGIGTGGDMMMGGGGGTGM
MMGMMMMMGGGMMGGGGGGMMMMGGGGGMGM
MGGMMTMMGGGMMGGGGMMTMMGTGGGGGGM
MMMMMMMMMMMMMMMMMMMMMMMMMMMMMMM
