MMMMMMMMMM
MGGIGGGGGM
MGGGGGGGGM
MGGGGGGGGM
MGEDGGGGGM
MGGGGGGGGM
MGGGGGGGGM
MGGGGGGGGM
MMMMMMMMMM
