MMMMMMMMMM
MGGIGGGGTM
MGGTGGGGGM
MGGTGGGGGM
MGEDGGGGTM
MGGBGGGGTM
MMMMMMMMMM
