MMMMMMMMMMMMMMMMMMMMMMMMMMMMMMMMMMMMMMMMMMMMMMMMMMMMMM
MGGGGGGTMGGMGGGGGGGMGGGMMMGMGMGMMGTGGGGGMGGMMMMMMGGGGM
MGGGGGGGGMMGGGG1GGGMMMGGMMMMGGGMMGMMMMGGGMGGGMMMGMGTMM
MGGGMMGGMGGDGGGGMGGMMMGGMMMMGMGGGGGMMGGGGGGMGMTMGGGD3M
MMBMMMGGGMGGGGMGGMGTMMGTMMMMGGTGGGGGMGTGDGGGGGMGTGMGGM
MGMGGGGMGBTGGMMMGGGMGGGBGMMMGGGGGMMMMMTGGMGGGGGGGTMMGM
MMGGGGGGTGGGGMMMGGGGGGMGGMMMGGGGGMMMMTGGGIGGGGGMMMMMGM
MGMGGGGGGGGGGGGMGM3GGGGDMMMMGGDMGGGMMMGGBGGMGGMMMGGMGM
MGGGGGGGGGGGMGGGGGGGGGGMMMTGGGMGGGGGGGGGBTMGGGGGGGMMMM
MGGGGGMGGGGMDGGGMGMMGGGMGGGGBMGGGGGGGMMGMGGGGGGGGGMMMM
MGTMGGGGMGGMGGGMGMMMGGGGGGGGGGMMGGGGGBGGGGGGMGGMMGMMMM
MGGGGGMMGMGMGGGDGMMMBGGMMG3GGBMMGGGGGGGGGGDGGGGMGGGGMM
MDGGMGGGGGMMGGG3MMMMGGGGGMGGGGGMMGBGMGMMGMGGMGGGGGMGGM
MGMGGGGDMG3GGGGGGTGGMGGGGGGGGGGGGGGDGMGGMGMGTMGGMGM1GM
MGGGGGGDGGGMGGMGGGGGMMGMMMMBGTTBGGGGGGGGGMGGGGGGGGGGGM
MMTGMMMM3MTGGGGGGGGGTGGGMMMMMGGMMG21GGGTGGMGGGTGMMMGGM
MGGGMMGGGGGGGMMGGGGDGGGGMMMMMGGGGGMGGGGGGGGGMGDGMMMMMM
MG1TGGGGGDGGGMMMGBGGG1GDGMGGGGGGMGGGGGGGGGGGGGGGMMMMMM
MGGGGGGGGMGGGGGGDGTGGGGGGGGMGMMGMGGGGMMGGTGMMGGMMMDMMM
MGMGMMGGGGGGMGGGGGGGGMMGGMGMGMMGMGGGGMMGMGGMMG3MMMGGGM
MGGGMMGGGGMGBGGGGGGGGMMGGGGBGMGGMGGGGMMMGGGGGGGMMMG4GM
MGGGGGTGGGGGMGGGGGGGGGMMGMGGMGGGGGGGGGGGGGTGGGGMMGGMGM
MGGGMGGGGGGMMGMMMMGGGMMGGGGMMMGGGGTGGGMGGMGGGMGDGMGGGM
MTGGBGGGGGGMMGMMMGGGGMGGGMMMMMGGGGGGTBGGGGBMBGGGGGGGGM
MMGMMGGGGGGG2GMMMGGGMGGGGMMMMMGGGMGMGGGGGGGGGGGGGGGGGM
MGGMMGGTGGMGGGGMGGGGMGGGGTGGGGMMMGMGMGGGGGGGGBGMGGGGMM
MBGGGGGMGGGGGBGGGGGGMGTGMMMGGGMMMGGGGGGGGMGMGDDGGG4GGM
MDGGGGDGGGGGGGTGGGGMMMGMMMMGGGMMMGMGGGMGMGGGDGGMGGGGGM
MGGGGGGGMMMGGGGGBGGGMTGMMMMGGGMTTMMGGGGGGMGGGGGMGGGDTM
MGGGGBGMMM1GGGGGGGGG2GMMMMGGMGMMGMMGGGGMMGMGGGGGGGGGGM
MGGMGGGMMMMMMGGMGMGGGGGGGGMGGGGGGGGGGTGMDGGGGGGMGGG3GM
MGGGMMMGMMMMGGTGGMMMGMGGGGGGMGMMGGGMGMGMMGMGGGMGGGGGBM
MMGGGMMGMMMMGGGMGMTMTGGGGGMMMGGGGGMGGGGGGGMGGGGGGG4GGM
MGGMMGMMGGMGGMMMGMTMMMMDGGMMMGGGGMGGGGGGGGGGGGGGGDMGGM
MGGGGMMMGGGMMMMMGGMTMMMGMGMMMGGGGMGGGGGGGGGGGMGGGMGGGM
MGMMMGGGBMGGMMMMGGDGMMMGGDGGBGGGGGMMMGGGGGMGGGGMGGGGMM
MGMMMMTDGGGTGGGGGGGMMGMGGMTGGMGGGGMMMGGGGGDTGGGGGGMMMM
MTMMMMMMGMGMGGGGGGGBGGGGMGMGGGGGGGMMM4MGTGMGGGGGGGMMMM
MGMGMGMMMMMGMDGGBGDGGGGGGMMMGGGGTG3GGGGGGGGGGGGMMGGGDM
MMMMMGGGMMMMMMGGGGMGGMMMMMGGGGGGMMGMGGGGGGGGGGGGGMGGGM
MGMMMGGGTMTMMMGGGGMMGMMMMGGMGGGGMMGMGGGGG1GMGGGGMMGGGM
MMGGGGGGGMGMMMGGGGMMGGMMMGGGGGGGGGGMMGGGGDGGGGGMTMGG2M
MGMGGMMGGGTGDGGGGGGMMEGGGGGMMGGDGGGMMTGGMMMGGGMGGMMDGM
MBGMMMMGGGGTGGGGMGGMMGGG2GGGGGBGMMGMMGGGGGGMGGMMGGGDMM
MDMMMGMGGMMMGGGGTGGGMG42GGGGGMGGGGMGGGGGTMMGGGMMGGGGGM
MGGGGGGMGGMMGGGGGGGGMTGDGMMGGMGGGMMMGGGGG3GBGGGGGGMGGM
MGGGMGMGGMGGGMMMMGGGMMGGDMMMGGGGBMMMGGGGGGG4GGGGGGMMMM
MGMMMGTGGDMGGMGGGGGGDDMGGMMMGGGGMMMMMGGGTGGGMGGTGGMMMM
MGMMMGGGGGGGGGGGMGGGGGGGMMMMGGGGGMMMGGGGG3MGMGG3GGMMMM
MGMMMGGMGGTGGGGMGGGGGGGGGGGGGGGG4GMMTMMBMGMMGGGGDGMGMM
MMMMMMMMMMMMMMMMMMMMMMMMMMMMMMMMMMMMMMMMMMMMMMMMMMMMMM